"filename", "language", "YAML", "Java", "SQL", "XML", "comment", "blank", "total"
"d:\java_project\we-mall\src\main\java\org\wendy\mall\WeMallApplication.java", "Java", 0, 9, 0, 0, 0, 3, 12
"d:\java_project\we-mall\src\main\java\org\wendy\mall\common\CommonResult.java", "Java", 0, 46, 0, 0, 35, 14, 95
"d:\java_project\we-mall\src\main\java\org\wendy\mall\common\ResultCode.java", "Java", 0, 20, 0, 0, 4, 5, 29
"d:\java_project\we-mall\src\main\java\org\wendy\mall\component\JwtAuthenticationTokenFilter.java", "Java", 0, 49, 0, 0, 6, 8, 63
"d:\java_project\we-mall\src\main\java\org\wendy\mall\component\RestAuthenticationEntryPoint.java", "Java", 0, 20, 0, 0, 6, 4, 30
"d:\java_project\we-mall\src\main\java\org\wendy\mall\component\RestfulAccessDeniedHandler.java", "Java", 0, 22, 0, 0, 6, 4, 32
"d:\java_project\we-mall\src\main\java\org\wendy\mall\config\SpringSecurityConfig.java", "Java", 0, 50, 0, 0, 65, 6, 121
"d:\java_project\we-mall\src\main\java\org\wendy\mall\config\Swagger2Config.java", "Java", 0, 32, 0, 0, 13, 5, 50
"d:\java_project\we-mall\src\main\java\org\wendy\mall\controller\UmsAdminController.java", "Java", 0, 57, 0, 0, 4, 7, 68
"d:\java_project\we-mall\src\main\java\org\wendy\mall\dao\UmsAdminMapper.java", "Java", 0, 7, 0, 0, 6, 2, 15
"d:\java_project\we-mall\src\main\java\org\wendy\mall\dao\UmsAdminRoleRelationMapper.java", "Java", 0, 10, 0, 0, 9, 3, 22
"d:\java_project\we-mall\src\main\java\org\wendy\mall\dao\entity\UmsAdmin.java", "Java", 0, 26, 0, 0, 6, 14, 46
"d:\java_project\we-mall\src\main\java\org\wendy\mall\dao\entity\UmsPermission.java", "Java", 0, 28, 0, 0, 6, 14, 48
"d:\java_project\we-mall\src\main\java\org\wendy\mall\dto\AdminUserDetails.java", "Java", 0, 48, 0, 0, 7, 11, 66
"d:\java_project\we-mall\src\main\java\org\wendy\mall\dto\UmsAdminLoginParam.java", "Java", 0, 13, 0, 0, 6, 5, 24
"d:\java_project\we-mall\src\main\java\org\wendy\mall\service\UmsAdminService.java", "Java", 0, 10, 0, 0, 16, 7, 33
"d:\java_project\we-mall\src\main\java\org\wendy\mall\service\impl\UmsAdminServiceImpl.java", "Java", 0, 86, 0, 0, 6, 14, 106
"d:\java_project\we-mall\src\main\java\org\wendy\mall\utils\JwtTokenUtil.java", "Java", 0, 80, 0, 0, 39, 18, 137
"d:\java_project\we-mall\src\main\resources\application.yml", "YAML", 19, 0, 0, 0, 1, 3, 23
"d:\java_project\we-mall\src\main\resources\mapper\UmsAdminRoleRelationDao.xml", "XML", 0, 0, 0, 35, 0, 0, 35
"d:\java_project\we-mall\src\main\resources\sql\role_and_admin.sql", "SQL", 0, 0, 108, 0, 29, 11, 148
"Total", "-", 19, 613, 108, 35, 270, 158, 1203